nnn AND wn1T1NGs oc ovn) ς

CRUTTWELL: Hc'story of Roman Lileralure (pp. 305-311).

' Mecmn: latin literature (pp. 13²·144)·

ancsnon-Mnns: Students' Companion to Latin Aullcors (pp.
eoo-213).

sennen: Roman Poels of tke Augustae Age: Horace ond tke
Elegcac Poets (Ch. V).

Suscox: History of Latin Literature (Vol. I, pp. 325-362).

Tnunnnn: History os Roman Lderoture (Vol. Ι, pp. 492-508).

TYRRELL: latin Poetry (pp. 123-125).

Mytlcology

Bonnmcn: The Age of Fable.

COLLlGnon: Manual os Mylkology.

D'OOGE: Helps to lke Sludy os Classical Mylkology.

DURUY: Hislory os Rome.

GAYLEY: Classic Mytks.

Gunnnnn: Myllcs of Greece and Rome.

flammosos-Tomos: Greek and Roman Mythology.
HAWTHORNE: Wonder·Book and T anglewood Tales.

HOMER: Iliad and Odyssey‚ translated by Bryant.

IHNE: Early Rome.

Knlcflcnnv: Mytkology os Ancient Greece ond Italy.

KELSEY: Oullc'nes of Greek and Roman Mylkology.

chsLnY: Tke Heroes: or, Greek Fac'ry Tales sor my Ckcldren.
LOWELL: Jason's Qccest.

Monsus: Epic os Hades.

MORRIS: Life ond Deallc assason.

MURRAY: Manuol of Mylkology.

PEcK: Harper's Dc'cle'onary of Classical LiteralureondArclcpuities.
spumans: Myllzology of Greece and Rom.

SEYFFERT: Dc'ctionary os Classical Antiquc'lies.

Snlnn ι De'cleonary os Greek and Roman Bcograpky and Myllcology.
Swmnunnn: Atalantam Calydon.

Vnncln: AEceee’d, translated by Conington. .

 

